%%%%%%%%%%%%%%%
%P......%%%%%%%
%.%%%%%.%%%%%%%
%.%%%.......%%%
%.%...%.%%%.%%%
%.%.%%%.%%%.%%%
%.............%
%%%.%%%.%%%.%.%
%%%.%%%.%...%.%
%%%.......%%%.%
%%%%%%%.%%%%%.%
%%%%%%%.......%
%%%%%%%%%%%%%%%
