%%%%%%%%%%%%%%%%%%%%%%%%%%%%%%%
%.....%......%%%%%......%.....%
%%%.%...%%%%........%.%...%.%%%
%...%%%.%.%%%%.%.%%%%%%.%%%...%
%.%.....%......%......%.....%.%
%.%%%.%%%%%.%%%%%%%.%%%.%.%%%%%
%.....%........P....%...%.....%
%%%%%%%%%%%%%%%%%%%%%%%%%%%%%%%
