%%%%%%%%%%%%%%%%%%%%
%.P          ..%   %
%.%%.%%.%%.%%.%% % %
%                % %
%%%%%%%%%%%%%%%%%% %
%.....             %
%%%%%%%%%%%%%%%%%%%%
